###################
### ### ####      #
###          #### #
############ #    #
#         ## ######
#     ### ##    ###
#     ### ####  ###
###             ###
###################