#********************************************************#
#********************************************************#
#********************************************************#
#********************************************************#
#********************************************************#
#********************************************************#
#********************************************************#
#********************************************************#
#********************************************************#
#*****************************###************************#
#********************************************************#
#************###*****************************************#
#*************************###****************************#
#****************####************************************#
#*********####*********************###*******************#
#*****************************###************************#
##########################################################