#*****************#
#*****************#
#*********####****#
#*****************#
###################