###################
###             ###
#     ### ####  ###
#     ### ##    ###
#         ## ######
############ #    #
###          #### #
### ### ####      #
###################